S S S S S S S S S S S S S G S S S S S S
S S S S S S S S S S S S S G S S S S S S
S S S S S S S S S S L P P P S S S S S S
S S S S S S S S S S L S S S S S S S S S
S S S S S S S S S S L S S S M M S S S S
S S S S S S S S S S L S S S M M S S S S
S S P L P P P P P L P P P P P P P P P P
S S S L S S S S S L S S S S S S S S S S
S S S L S S S S S S S S S S S S S S S S
S S S L S S S S S S S S S S S S S S S S
P P P P P P P P P P P P P L P S S S S S
S S S S S S S S S S S S S L S S S S S S
S S S S S L S S S S S S S L S S S S S S
S S S S S L S S S S S S S L S S S S S S
S S P P L P P P P P P P P P P P P P P P
S S S S L S S S S S S S L S S S S S S S
S S S S L S S S S S S S S S S S S S S S
S S S S L S S S S S S S S S O S S S S S
S S S S L S S S S S S S L J O S S S S S
P P P P P P P P P P P P P P P P P P P P
