M S G S S S S S S S
P P P P P P P L P S
S S S S S S S L S S
S S S S S S S L S S
S P L P P P P P P P
S S L S S S S S S S
S S L S S S S S S S
P P P P P P P P P P
S S S S S S S S S S
S S S S S S S S S S