S S S S G S S S S S S S S S S S S S S S
S S S S G F F S S S S S S S S S S S S S
S M M S P P L S S S S S S S S S S S S S
B M M A S S L S S S S S S S S S S S S S
P P P P P P P P P P S S S S S S S S S S
S C S S S S S S S S P P S S S S S S S S
S S S S S S S S S S S S P P S S S S S S
P P L P S S S H S S S S S S P P S S S S
S S L S S S S S S S S S S S S S P L P S
S S L S S S S S S S S S S S S S S L S S
S S L S S S S S S S S S S S S S S L S S
P P P P P L P S S S S S P P L P P P P P
S S S S S L S S S S S S S S L S S S S S
S S S S S L S S S S S S S S L S S S S S
S S S S S L S S S S S S S S L S S S S S
S S P P L P P P P P P P P P P P P P P P
S S S S L S S S S S S S S S S S S S S S
S S S S L S S S S S S S S S O S S S S S
S S S S L S S S S S S S S J O S S S S S
P P P P P P P P P P P P P P P P P P P P